+---+---+---+---+---+
| .   .   .   E   E |
+   +   +   +---+---+
| .   .   . | p   b |
+   +   +   +---+   +
| .   .   . | c   i |
+   +   +   +---+---+
| .   .   .   .   P |
+   +   +   +   +   +
| .   f   .   .   . |
+---+---+---+---+---+
